000000000100000000!
000000000100000000!
000000000100000000!
001111100111111100!
001000110000000100!
001000011111111100!
001000000000000000!
001111111111000000!
000000000001000000!
000000000001000000!